. . . . . . . . . . . . . . . . . . @ . . . . . . . . . @ . . . . . . . . . . . .
. . . . @ . . . . . 8 . . 1 2 2 2 2 2 2 2 3 . . . . . . . . . . . . . . . . . . . .
8 . . . . . . . . . . . . . . . . . . . . . . . . . . . . 8 . . . . . . . . . 1 2 2
1 2 2 2 2 2 2 3 . . . # . . . . . . . . . . . . . . 1 2 2 2 3 . . . @ . . . . 4 6 6
4 6 6 6 6 6 6 2 2 2 2 2 2 3 . . . . 8 . . . . . . . 4 6 6 6 5 . . . . . . . . 4 6 6
4 6 6 6 6 6 6 6 6 6 6 6 6 5 . # . . 7 . . . . # . . 4 6 6 6 5 . . . . . . . . 4 6 6
4 6 6 6 6 6 6 6 6 6 6 6 6 2 2 2 2 2 2 2 2 2 2 2 2 2 2 6 6 6 2 2 2 3 . @ . . 1 2 6 6
6 6 6 6 6 6 6 6 6 6 6 6 6 6 6 6 6 6 6 6 6 6 6 6 6 6 6 6 6 6 6 6 6 5 . . . . 4 6 6 6
6 6 6 6 6 6 6 6 6 6 6 6 6 6 6 6 6 6 6 6 6 6 6 6 6 6 6 6 6 6 6 6 6 5 . . . . 4 6 6 6
6 6 6 6 6 6 6 6 6 6 6 6 6 6 6 6 6 6 6 6 6 6 6 6 6 6 6 6 6 6 6 6 6 5 . @ . . 4 6 6 6
. . . . . . . . . . . . . . . . . . . . . . 4 6 6 6 6 6 6 6 6 6 6 5 . . . 1 2 6 6 6
. . . . . . . . @ . . . . . . . . . . . . . . . . . . . . . . . . . . . . . 4 6 6 6
8 . . . . # . . 8 . . . . . . . . . . . . @ . . . . . @ . . . . . . . 8 . . 4 6 6 6
2 2 2 2 2 2 2 2 2 2 2 3 . . . @ . . . . . 8 . . . . . 8 . # . . 1 2 2 2 2 2 2 6 6 6
6 6 6 6 6 6 6 6 6 6 6 5 . . . . . . . . . 1 3 . . . 1 2 2 2 2 2 2 6 6 6 6 6 6 6 6 6
6 6 6 6 6 6 6 5 . . . . . . . @ . . . . . 7 . . . 1 2 6 6 6 6 6 6 6 6 6 6 6 6 6 6 6
6 6 6 6 6 6 6 5 . . . . . . . . . . . . . 7 . . . . 4 6 6 6 6 6 6 6 6 6 6 6 6 6 6 6
. . . . . . . . . . . . . . . . 8 . . . . 1 3 . . . . . . . . . . . . . . . 4 6 6 6
8 . . . . . . . . . . . . . . . 7 . . . . . . # . . . . . @ . . . . # . . . 4 6 6 6
2 2 2 2 2 2 2 2 2 2 2 2 2 2 2 2 2 2 2 2 2 2 2 2 2 2 2 2 2 2 2 2 2 2 2 2 2 2 2 6 6 6
6 6 6 6 6 6 6 6 6 6 6 6 6 6 6 6 6 6 6 6 6 6 6 6 6 6 6 6 6 6 6 6 6 6 6 6 6 6 6 6 6 6
6 6 6 6 6 6 6 6 6 6 6 6 6 6 6 6 6 6 6 6 6 6 6 6 6 6 6 6 6 6 6 6 6 6 6 6 6 6 6 6 6 6
6 6 6 6 6 6 6 6 6 6 6 6 6 6 6 6 6 6 6 6 6 6 6 6 6 6 6 6 6 6 6 6 6 6 6 6 6 6 6 6 6 6
6 6 6 6 6 6 6 6 6 6 6 6 6 6 6 6 6 6 6 6 6 6 6 6 6 6 6 6 6 6 6 6 6 6 6 6 6 6 6 6 6 6